bow-shaped - wygięty w łuk;
broad nose - szeroki nos;
button nose - nos jak guzik;
clean shaven face - gładko ogolona twarz;
fair hair - jasne włosy;
fair complexion - jasna cera;
freckled face - piegowata twarz;
full lips - pełne usta;
long - podłużny;
oval face - owalna twarz;
puffy face - opuchnięta twarz;
straight hair - proste włosy;
thin lips - wąskie usta;
wavy hair - falowane włosy;
youthful appearance - młodzieńczy wygląd;
baggy - workowaty;
casual - nieformalny, codzienny;
checked - w kratkę;
cotton - bawełniany;
denim - dżinsowy;
floral - w kwiaty;
formal - oficjalny, formalny;
high-heeled - na wysokim obcasie;
leather - skórzany;
linen - lniany, płócienny;
long-sleeved - z długim rękawem;
loose - luźny;
material - materiał;
multicoloured - wielobarwny;
oversized - za duży;
pattern - wzór;
plain - gładki;
polka dot - w kropki;
polo-neck - golf;
short-sleeved - z krótkim rękawem;
silk - jedwabny;
smart - elegancki;
striped - w paski;
tight-fitting - obcisły;
trendy - modny;
woollen - wełniany;
confident - pewny siebie;
conservative - konserwatywny;
creative - kreatywny;
dedicated (to sth) - oddany (czemuś), zaangażowany (w coś);
extrovert - ekstrawertyczny;
gullible - łatwowierny;
impatient - niecierpliwy;
introvert - introwertyczny;
kind-hearted - życzliwy;
knowledgeable - mądry, znający się na rzeczy;
moody - humorzasty;
passionate - pełen pasji;
perceiving - postrzegający;
reliable - niezawodny;
sensitive - wrażliwy;
sentimental - sentymentalny;
sociable - towarzyski;
trustworthy - godny zaufania;
visionary - wizjonerski;
anxious - zaniepokojony;
appalled - przerażony, zbulwersowany;
delighted - zachwycony;
embarrassed - zakłopotany;
excessive - nadmierny;
excited - podekscytowany;
exhilarated - radosny;
furious - wściekły, rozwścieczony;
intuitive - posługujący się intuicją;
isolated - odizolowany;
judging - oceniający;
miserable - przygnębiony;
petrified - sparaliżowany strachem;
scared - przerażony;
sensing - czujący;
shocked - wstrząśnięty;
upset - zmartwiony;
to bite one's nails - obgryzać paznokcie;
blush - rumienić się;
clench one's fists - zaciskać pięści;
cross one's legs - zakładać nogę na nogę;
drop one's head - spuszczać głowę;
fold one's arms - skrzyżować ramiona;
frown - marszczyć brwi;
to purse one's lips - zaciskać usta;
scratch one's head - zachodzić w głowę;
to shrug one's shoulders - wzruszyć ramionami;
to stroke one's chin - gładzić się po brodzie;
wink - mrugać okiem;
yawn - ziewać;
bank card - karta kredytowa (Am. English), karta czekowa (Br. English);
charger - ładowarka;
credit card - karta kredytowa;
desktop computer - komputer stacjonarny;
driving licence - prawo jazdy;
earphone - słuchawka douszna;
handbag - torebka;
jewellery - biżuteria;
phone - telefon;
rucksack - plecak;
tablet - tablet;
wallet - portfel;
adolescent - dorastający chłopak/dziewczyna;
adult - dorosły;
era - era, epoka;
grown-up - dorosły;
infant - niemowlę;
middle-aged - w średnim wieku;
newborn - noworodek;
pensioner - emeryt;
school-aged - w wieku szkolnym;
senior citizen - starsza osoba;
teenager - nastolatek;
toddler - dziecko uczące się chodzić;
young adult - młody dorosły;
youngster - młoda osoba;
addiction - uzależnienie;
celebrity - celebryta;
death penalty - kara śmierci;
equality of the sexes - równouprawnienie płci;
ethnic minorities - mniejszości etniczne;
freedom of speech - wolność słowa;
future generations - przyszłe pokolenia;
homelessness - bezdomność;
human rights - prawa człowieka;
impact - wpływ;
impressionable - podatny na wpływy;
in the public eye - na oczach opinii publicznej;
influence - wpływ;
mentally ill - chory psychicznie;
moral duty - moralny obowiązek;
to network with - nawiązywać kontakty z;
obligation - zobowiązanie;
peer - rówieśnik;
peer pressure - presja rówieśników;
persecution - prześladowanie;
popular - popularny;
positive - pozytywny;
promote change - promować zmiany;
protest (against sth) - protestować (przeciwko czemuś);
racial discrimination - dyskryminacja na tle rasowym;
responsibility - odpowiedzialność;
social security - opieka społeczna;
society - społeczeństwo;
the privilege of freedom - przywilej wolności;
the right to vote - prawo wyborcze;
career counsellor - doradca zawodowy;
coach - trener;
headteacher - dyrektor szkoły;
older sibling - starsze rodzeństwo;
parents - rodzice;
police officer - policjant/policjantka;
president - prezydent;
supervisor - nadzorca, kierownik;
active - aktywny;
analysis - analiza;
birdwatching - obserwacja ptaków;
blogging - prowadzenie bloga;
boring - nudny;
camping - biwakowanie, spanie pod namiotem;
chess - szachy;
editing - edycja;
fishing - wędkarstwo;
focus on sth - skupienie uwagi na czymś;
hiking - turystyka piesza;
hunting - polowanie;
map reading - czytanie mapy;
memory - pamięć;
navigation - nawigacja;
organisation - organizacja;
patience - cierpliwość;
planning - planowanie;
reading - czytanie;
self-confidence - pewność siebie;
spend time outdoors - spędzać czas na świeżym powietrzu;
strategy - strategia;
teamwork - praca zespołowa;
travelling - podróżowanie;
white water rafting - spływ pontonem górskimi rzekami;
writing - pisanie;
age - wiek;
age group - grupa wiekowa;
appearance - wygląd;
career - kariera zawodowa;
citizenship - obywatelstwo;
education - wykształcenie;
employee - pracownik;
ethnicity - tożsamość etniczna;
habit - nawyk;
occupation - zawód;
personality - osobowość;
profession - profesja, zawód;
unemployed - bezrobotny;
be a member of - być członkiem;
community - społeczność;
collective identity - tożsamość zbiorowa;
custom - zwyczaj, tradycja;
define - określić (się);
get a feeling of belonging - mieć poczucie przynależności;
maintain friendship - utrzymywać przyjaźń;
personal identity - tożsamość indywidualna;
resident - mieszkaniec;
sense of belonging - poczucie przynależności;
sexuality - seksualność;
shared belief - wspólne przekonania;